###############
S            ##
#  #########  #
#           #E#
###############