##########
#        #
#  #######
##      ##
###    ###
##      ##
#  #######
#        #
#  #######
##########