###############################################################################################################
#                                                                                                            ##
#                                                                                                            ##
#                                                                                                            ##
#                                                                                                            ##
#                                                                                                            ##
#                                                                                                            ##
#               E                                                                                             #
#                                                                                                            ##
#                                                                                                            ##
#                                                                                                            ##
#                                                                                                            ##
#                                                                                                            ##
#                                                                                                            ##
#                                                                                                            ##
#                                                                                                            ##
#                                                                                                            ##
#                                                                                                            ##
#                                                                                                            ##
#                                                                                                            ##
#                                                                                                            ##
#                                                                                                            ##
#                                                                                                            ##
#                                                                                                            ##
#                                                                                                  ############
#                                                                                                  #          #
#                                                                                                  #          #
#                                                                                                  #          #
#                                                                                                  #          #
#                                                                                                  #          #
#                                                                                                  #          #
#                                                                                                  #          #
#                                                                                                  #          #
#                                                                                                  #          #
#                                                                                                  #          #
#                                                                                                  #          #
#                                                                                                  #          #
#                                                                                                  #          #
#                                                                                                  #          #
#                                                                                                  #          #
#                                                                                                  #          #
#                                                                                                  #          #
#                                                                                                  #          #
#                                                                                                  #          #
#                                                                                         S        #          #
###############################################################################################################