##### ######
#S         #
#  #####   #
#     #    #
##### #    #
#     E    #
#     #    #
#          #
############