## ## #
# S  ##
#  #  #
#E# # #
 # ### 
## # ## 