#######
#E#####
#######
###S###
#######