S#########
         
#  #######
#       ##
###  #####
##       #
####  ####
###      #
###  #####
##      ##
#    #####
#        #
#  #######
#       ##
##########