############
#SE      #
#        #
#        #
#        #
#        #
#        #
##########