#############
#S          #
# #######   #
#        #  #
#   ######  #
#        E  #
#############