##### #
#S  ###
# ##  #
#E# # #
 # ### 
## # ## 