##### #
#S  ## 
# ##  #
#E# # #
 # ### 
## # ## 