##### ##
#S  ## #
# ##  # 
#E# # # 
 # ### #
## # ## 
#   ## #