##### #
#SE ###
# ##  #
### # #
 # ### 
## # ## 