#################
#SE######     # #
#  #           # 
#  #           # 
#     #####    # 
#        #     # 
#        #     # 
#################